30 15
------------------------------
------------------------------
-------##############---------
------#.F.#.F#......#---------
------#S@E#..#......#---------
------#.W.#....#....#---------
-------#.#####.#....#---------
------#........#....#---------
------#...S.W.E#....#---------
------#...X#X#X######---------
-------#########--------------
------------------------------
------------------------------
------------------------------
------------------------------
