30 15
------------------------------
------------------------------
-------##############---------
------#...#..#......#---------
------#.@.#..#......#---------
------#...#....#....#---------
-------#.#####.#....#---------
------#........#....#---------
------#...S.W.E#....#---------
------#...X#X#X######---------
-------#########--------------
------------------------------
------------------------------
------------------------------
------------------------------
