45 38
---------------------------------------------
---------------------------------------------
---------------------------------------------
---------------------------------------------
---------------------------------------------
---------------------------------------------
---------------------------------------------
-------------------###-----------------------
------------------##F##----------------------
-----------------##...##---------------------
-----------------#S...S#---------------------
-----------------#S...S#---------------------
----------------####|####--------------------
---------------#WA#...#AW#-------------------
----#---------#...#...#...#---------#--------
----#--------##...|...|...##--------#--------
---#X#-------##...#.#.#...##-------#X#-------
---#.#-------###...###....##-------#.#-------
---#.#-------####|#####|####-------#.#-------
---#.#-------#X#....#.....##-------#.#-------
---#.#-------#.#.@..|......#-------#.#-------
---#.#-------#.#....#.....##-------#.#-------
---#.#-------#|##|##########-------#.#-------
---#.#########......#XXXXXX#########.#-------
---#.......|.|.............|.|.......#-------
---#############..###......###########-------
---#--#X#--#-##...#........#-#--#X#--#-------
---#--#X#----#....#........#----#X#--#-------
---#---X-----#....#####|####-----X---#-------
-------------###|##XX.....X#-----------------
-------------#............X#-----------------
--------------#..XXEEEXX..#------------------
---------------#XXXX#XXXX#-------------------
-----------------XX---XX---------------------
-----------------XX---XX---------------------
---------------------------------------------
---------------------------------------------
---------------------------------------------
