45 25
---------------------------------------------
---------------------------------------------
---------------------------------------------
---------------------------------------------
---------------------------------------------
---------------------------------------------
------------------###------------------------
-----------------#...###---------------------
-----------------#....WX###------------------
------------###--#.....W...#-----------------
------------#XE#####.#####.#####-------------
------------#E..#XXX#...#..@.#SX##-----------
------------#..................SFX#----------
------------#...#XXX#...#....#..##-----------
------------#..#####.#.###.#####-------------
------------###--#.........#-----------------
-----------------#......###------------------
-----------------#...###---------------------
------------------###------------------------
---------------------------------------------
---------------------------------------------
---------------------------------------------
---------------------------------------------
---------------------------------------------
--------------------------------------------#
